//MAP CONVERTED BY dmm2tgm.py THIS HEADER COMMENT PREVENTS RECONVERSION, DO NOT REMOVE
"a" = (
/obj/machinery/suit_storage_unit/explorer,
/obj/structure/cable,
/obj/machinery/power/apc/auto_name/directional/east,
/obj/machinery/light/directional/east,
/obj/effect/turf_decal/stripes/line{
	dir = 10
	},
/obj/machinery/firealarm/directional/south,
/turf/open/floor/iron/dark,
/area/station/command/gateway)
"i" = (
/turf/template_noop,
/area/template_noop)
"r" = (
/obj/effect/landmark/start/explorer,
/obj/effect/landmark/event_spawn,
/obj/machinery/holopad,
/turf/open/floor/iron,
/area/station/command/gateway)
"z" = (
/obj/effect/landmark/start/explorer,
/obj/structure/cable,
/obj/effect/turf_decal/stripes/line,
/turf/open/floor/iron,
/area/station/command/gateway)
"J" = (
/obj/machinery/suit_storage_unit/explorer,
/obj/machinery/airalarm/directional/east,
/obj/effect/turf_decal/stripes/line{
	dir = 9
	},
/turf/open/floor/iron/dark,
/area/station/command/gateway)

(1,1,1) = {"
i
i
i
"}
(2,1,1) = {"
i
i
i
"}
(3,1,1) = {"
i
r
z
"}
(4,1,1) = {"
i
J
a
"}
